  /        |                                                                  |        \
 /         |                                                                  |         \
|          |                                                                  |          |
|          |                                                                  |          |
|          |                                                                  |          |
|          |                                                                  |          |
|          |                                                                  |          |
|          |                                                                  |          |
|          |                                                                  |          |
|          |                                                                  |          |
|          |                                                                  |          |
|          |                                                                  |          |
|          |                                                                  |          |
|          |                                                                  |          |
|          |__________________________________________________________________|          |
|         /                                                                    \         |
|        /                                                                      \        |
|       /                                                                        \       |
|      /                                                                          \      |
|     /                                                                            \     |
|    /                                                                              \    |
|   /                                                                                \   |
|  /                                                                                  \  |
| /                                                                                    \ |
|/______________________________________________________________________________________\|