  /        |                                    |        \
 /         |                                    |         \
|          |                                    |          |
|          |                                    |          |
|          |                                    |          |
|          |                                    |          |
|          |                                    |          |
|          |                                    |          |
|          |                                    |          |
|          |                                    |          |
|          |                                    |          |
|          |                                    |          |
|          |                                    |          |
|          |                                    |          |
|          |____________________________________|          |
|         /                                      \         |
|        /                                        \        |
|       /                                          \       |
|      /                                            \      |
|     /                                              \     |
|    /                                                \    |
|   /                                                  \   |
|  /                                                    \  |
| /                                                      \ |
|/________________________________________________________\|